0, 1571881058032, 1571881058061, 1571881058510, 478, 449, 29
1, 1571881089190, 1571881089220, 1571881089535, 345, 315, 30
2, 1571881178462, 1571881178491, 1571881179590, 1128, 1099, 29
3, 1571881238751, 1571881238778, 1571881239814, 1063, 1036, 27
4, 1571881268951, 1571881268979, 1571881269810, 859, 831, 28
5, 1571881390451, 1571881390488, 1571881391553, 1102, 1065, 37
6, 1571881480816, 1571881480841, 1571881481758, 942, 917, 25
7, 1571881541069, 1571881541098, 1571881541963, 894, 865, 29
8, 1571881601328, 1571881601355, 1571881602191, 863, 836, 27
9, 1571881661669, 1571881661697, 1571881662073, 404, 376, 28
10, 1571881721869, 1571881721903, 1571881722227, 358, 324, 34
11, 1571881783211, 1571881783237, 1571881784293, 1082, 1056, 26
12, 1571881833414, 1571881833446, 1571881834421, 1007, 975, 32
13, 1571881893707, 1571881893735, 1571881894540, 833, 805, 28
14, 1571881954015, 1571881954043, 1571881954659, 644, 616, 28
15, 1571882014312, 1571882014338, 1571882014912, 600, 574, 26
16, 1571882074613, 1571882074636, 1571882074919, 306, 283, 23
17, 1571882134908, 1571882134934, 1571882136017, 1109, 1083, 26
18, 1571882195221, 1571882195245, 1571882196068, 847, 823, 24
19, 1571882256516, 1571882256541, 1571882257291, 775, 750, 25
20, 1571882316842, 1571882316868, 1571882317078, 236, 210, 26
21, 1571882376044, 1571882376073, 1571882377206, 1162, 1133, 29
22, 1571882437279, 1571882437300, 1571882438249, 970, 949, 21
23, 1571882497554, 1571882497583, 1571882498391, 837, 808, 29
24, 1571882558853, 1571882558875, 1571882565955, 7102, 7080, 22
25, 1571882618079, 1571882618106, 1571882618876, 797, 770, 27
26, 1571882648236, 1571882648261, 1571882648985, 749, 724, 25
27, 1571882739644, 1571882739670, 1571882740163, 519, 493, 26
28, 1571882799970, 1571882799991, 1571882800354, 384, 363, 21
29, 1571882859213, 1571882859241, 1571882860312, 1099, 1071, 28
30, 1571882919477, 1571882919507, 1571882920406, 929, 899, 30
31, 1571882980716, 1571882980746, 1571882981596, 880, 850, 30
32, 1571883040945, 1571883040970, 1571883041787, 842, 817, 25
33, 1571883100143, 1571883100170, 1571883100653, 510, 483, 27
34, 1571883160406, 1571883160435, 1571883160794, 388, 359, 29
35, 1571883220643, 1571883220673, 1571883221830, 1187, 1157, 30
36, 1571883280918, 1571883280946, 1571883281941, 1023, 995, 28
37, 1571883341203, 1571883341232, 1571883342101, 898, 869, 29
38, 1571883401429, 1571883401457, 1571883402122, 693, 665, 28
39, 1571883461651, 1571883461681, 1571883462242, 591, 561, 30
40, 1571883531965, 1571883531992, 1571883532334, 369, 342, 27
41, 1571883562106, 1571883562131, 1571883562398, 292, 267, 25
42, 1571883652441, 1571883652467, 1571883653598, 1157, 1131, 26
43, 1571883712638, 1571883712664, 1571883713567, 929, 903, 26
44, 1571883732700, 1571883732728, 1571883733592, 892, 864, 28
