0, 1571888228382, 1571888228415, 1571888229159, 777, 744, 33
1, 1571888258521, 1571888258546, 1571888259287, 766, 741, 25
2, 1571888288603, 1571888288631, 1571888289307, 704, 676, 28
3, 1571888409023, 1571888409053, 1571888409502, 479, 449, 30
4, 1571888469318, 1571888469346, 1571888469608, 290, 262, 28
5, 1571888499482, 1571888499505, 1571888500618, 1136, 1113, 23
6, 1571888559756, 1571888559785, 1571888560315, 559, 530, 29
7, 1571888647089, 1571888647123, 1571888647625, 536, 502, 34
8, 1571888711366, 1571888711393, 1571888712533, 1167, 1140, 27
9, 1571888771599, 1571888771629, 1571888772658, 1059, 1029, 30
10, 1571888862058, 1571888862085, 1571888862904, 846, 819, 27
11, 1571888952397, 1571888952423, 1571888953196, 799, 773, 26
12, 1571888982592, 1571888982612, 1571888982980, 388, 368, 20
13, 1571889073031, 1571889073059, 1571889074241, 1210, 1182, 28
14, 1571889133345, 1571889133372, 1571889134526, 1181, 1154, 27
15, 1571889163536, 1571889163553, 1571889164396, 860, 843, 17
16, 1571889253935, 1571889253955, 1571889254715, 780, 760, 20
17, 1571889314206, 1571889314229, 1571889314889, 683, 660, 23
18, 1571889374522, 1571889374547, 1571889375003, 481, 456, 25
19, 1571889434833, 1571889434852, 1571889435901, 1068, 1049, 19
20, 1571889495060, 1571889495090, 1571889495999, 939, 909, 30
21, 1571889556460, 1571889556479, 1571889557014, 554, 535, 19
22, 1571889584557, 1571889584575, 1571889585116, 559, 541, 18
23, 1571889676890, 1571889676916, 1571889677356, 466, 440, 26
24, 1571889737164, 1571889737190, 1571889738386, 1222, 1196, 26
25, 1571889767302, 1571889767322, 1571889768330, 1028, 1008, 20
26, 1571889857700, 1571889857723, 1571889858525, 825, 802, 23
27, 1571889917914, 1571889917943, 1571889918623, 709, 680, 29
28, 1571889973192, 1571889973220, 1571889973802, 610, 582, 28
29, 1571890038564, 1571890038586, 1571890039728, 1164, 1142, 22
30, 1571890068749, 1571890068774, 1571890069855, 1106, 1081, 25
31, 1571890125970, 1571890125998, 1571890126940, 970, 942, 28
32, 1571890219262, 1571890219290, 1571890220063, 801, 773, 28
33, 1571890279495, 1571890279525, 1571890280230, 735, 705, 30
34, 1571890339760, 1571890339787, 1571890340118, 358, 331, 27
35, 1571890369919, 1571890369945, 1571890370220, 301, 275, 26
36, 1571890456210, 1571890456239, 1571890457436, 1226, 1197, 29
37, 1571890512487, 1571890512516, 1571890513439, 952, 923, 29
38, 1571890537638, 1571890537667, 1571890538404, 766, 737, 29
39, 1571890642087, 1571890642115, 1571890642577, 490, 462, 28
40, 1571890691209, 1571890691237, 1571890691665, 456, 428, 28
41, 1571890732434, 1571890732456, 1571890732813, 379, 357, 22
42, 1571890822780, 1571890822810, 1571890824021, 1241, 1211, 30
43, 1571890882967, 1571890882996, 1571890883967, 1000, 971, 29
44, 1571890943190, 1571890943219, 1571890944518, 1328, 1299, 29
