0, 1571858428392, 1571858428460, 1571858429589, 1197, 1129, 68
1, 1571858498600, 1571858498633, 1571858499411, 811, 778, 33
2, 1571858533743, 1571858533776, 1571858534546, 803, 770, 33
3, 1571858603935, 1571858603964, 1571858604609, 674, 645, 29
4, 1571858674163, 1571858674193, 1571858674600, 437, 407, 30
5, 1571858709305, 1571858709336, 1571858709761, 456, 425, 31
6, 1571858778536, 1571858778562, 1571858779689, 1153, 1127, 26
7, 1571858849769, 1571858849800, 1571858850807, 1038, 1007, 31
8, 1571858920023, 1571858920053, 1571858920908, 885, 855, 30
9, 1571858955191, 1571858955218, 1571858955934, 743, 716, 27
10, 1571858989275, 1571858989305, 1571858990018, 743, 713, 30
11, 1571859517129, 1571859517156, 1571859517520, 391, 364, 27
12, 1571859552269, 1571859552297, 1571859553762, 1493, 1465, 28
13, 1571859622537, 1571859622553, 1571859623624, 1087, 1071, 16
14, 1571859692843, 1571859692868, 1571859693849, 1006, 981, 25
15, 1571859763081, 1571859763099, 1571859763786, 705, 687, 18
16, 1571859798202, 1571859798217, 1571859799013, 811, 796, 15
17, 1571859868469, 1571859868493, 1571859869055, 586, 562, 24
18, 1571859938738, 1571859938760, 1571859939019, 281, 259, 22
19, 1571859973845, 1571859973859, 1571859974161, 316, 302, 14
20, 1571860044137, 1571860044161, 1571860045368, 1231, 1207, 24
21, 1571860114456, 1571860114472, 1571860115314, 858, 842, 16
22, 1571860184717, 1571860184736, 1571860185502, 785, 766, 19
23, 1571860219840, 1571860219863, 1571860220452, 612, 589, 23
24, 1571860290198, 1571860290215, 1571860290755, 557, 540, 17
25, 1571860360449, 1571860360468, 1571860360726, 277, 258, 19
26, 1571860395580, 1571860395611, 1571860396828, 1248, 1217, 31
27, 1571860465871, 1571860465892, 1571860466909, 1038, 1017, 21
28, 1571860536153, 1571860536167, 1571860537141, 988, 974, 14
29, 1571860711686, 1571860711712, 1571860712294, 608, 582, 26
30, 1571860781991, 1571860782017, 1571860782480, 489, 463, 26
31, 1571860817090, 1571860817116, 1571860817415, 325, 299, 26
32, 1571860887334, 1571860887349, 1571860888518, 1184, 1169, 15
33, 1571860957625, 1571860957656, 1571860958856, 1231, 1200, 31
34, 1571860992769, 1571860992784, 1571860993923, 1154, 1139, 15
35, 1571861027892, 1571861027923, 1571861029132, 1240, 1209, 31
36, 1571861565628, 1571861565645, 1571861567016, 1388, 1371, 17
37, 1571861600807, 1571861600834, 1571861602126, 1319, 1292, 27
38, 1571861671031, 1571861671058, 1571861671989, 958, 931, 27
39, 1571861741235, 1571861741250, 1571861742162, 927, 912, 15
40, 1571861776308, 1571861776323, 1571861777174, 866, 851, 15
41, 1571861846560, 1571861846574, 1571861847204, 644, 630, 14
42, 1571861916769, 1571861916796, 1571861917291, 522, 495, 27
43, 1571861986995, 1571861987009, 1571861987402, 407, 393, 14
