0, 1571895016975, 1571895016995, 1571895017601, 626, 606, 20
1, 1571895027037, 1571895027063, 1571895027555, 518, 492, 26
2, 1571895137375, 1571895137399, 1571895137587, 212, 188, 24
3, 1571895177541, 1571895177568, 1571895178577, 1036, 1009, 27
4, 1571895378173, 1571895378203, 1571895378776, 603, 573, 30
5, 1571895438321, 1571895438350, 1571895438854, 533, 504, 29
6, 1571895498521, 1571895498549, 1571895498811, 290, 262, 28
7, 1571895558809, 1571895558844, 1571895559925, 1116, 1081, 35
8, 1571895568879, 1571895568911, 1571895569935, 1056, 1024, 32
9, 1571895799894, 1571895799923, 1571895800146, 252, 223, 29
10, 1571895860145, 1571895860171, 1571895861198, 1053, 1027, 26
11, 1571895920389, 1571895920415, 1571895921370, 981, 955, 26
12, 1571895970651, 1571895970677, 1571895971384, 733, 707, 26
13, 1571896040995, 1571896041024, 1571896041552, 557, 528, 29
14, 1571896091183, 1571896091202, 1571896091513, 330, 311, 19
15, 1571896211821, 1571896211845, 1571896212734, 913, 889, 24
16, 1571896282222, 1571896282249, 1571896282846, 624, 597, 27
17, 1571896332516, 1571896332542, 1571896332854, 338, 312, 26
18, 1571896402876, 1571896402901, 1571896403944, 1068, 1043, 25
19, 1571896463202, 1571896463230, 1571896464064, 862, 834, 28
20, 1571896523562, 1571896523591, 1571896524211, 649, 620, 29
21, 1571896583838, 1571896583867, 1571896584808, 970, 941, 29
22, 1571896644217, 1571896644244, 1571896645092, 875, 848, 27
23, 1571896704521, 1571896704548, 1571896705072, 551, 524, 27
24, 1571896764850, 1571896764878, 1571896765149, 299, 271, 28
25, 1571896825184, 1571896825213, 1571896826131, 947, 918, 29
26, 1571896885407, 1571896885436, 1571896886235, 828, 799, 29
27, 1571896945683, 1571896945709, 1571896946299, 616, 590, 26
28, 1571896995914, 1571896995942, 1571896996311, 397, 369, 28
29, 1571897046151, 1571897046178, 1571897046386, 235, 208, 27
30, 1571897186817, 1571897186845, 1571897187723, 906, 878, 28
31, 1571897247194, 1571897247225, 1571897247646, 452, 421, 31
32, 1571897297467, 1571897297493, 1571897297750, 283, 257, 26
33, 1571897357767, 1571897357794, 1571897358815, 1048, 1021, 27
34, 1571897377904, 1571897377930, 1571897378917, 1013, 987, 26
35, 1571897553345, 1571897553373, 1571897554638, 1293, 1265, 28
36, 1571897603567, 1571897603594, 1571897604720, 1153, 1126, 27
37, 1571897663853, 1571897663875, 1571897664731, 878, 856, 22
38, 1571897724059, 1571897724087, 1571897724723, 664, 636, 28
39, 1571897784315, 1571897784338, 1571897784846, 531, 508, 23
40, 1571897844677, 1571897844696, 1571897846211, 1534, 1515, 19
41, 1571897904864, 1571897904890, 1571897905967, 1103, 1077, 26
42, 1571897964080, 1571897964107, 1571897965186, 1106, 1079, 27
43, 1571898025378, 1571898025403, 1571898026126, 748, 723, 25
44, 1571898075536, 1571898075564, 1571898076190, 654, 626, 28
