0, 1571865737312, 1571865737350, 1571865737886, 574, 536, 38
1, 1571865797569, 1571865797601, 1571865797984, 415, 383, 32
2, 1571865876766, 1571865876798, 1571865878011, 1245, 1213, 32
3, 1571865958033, 1571865958065, 1571865959119, 1086, 1054, 32
4, 1571865977196, 1571865977219, 1571865978143, 947, 924, 23
5, 1571866037327, 1571866037366, 1571866038146, 819, 780, 39
6, 1571866097568, 1571866097597, 1571866098233, 665, 636, 29
7, 1571866218008, 1571866218038, 1571866218313, 305, 275, 30
8, 1571866278236, 1571866278265, 1571866279400, 1164, 1135, 29
9, 1571866366463, 1571866366490, 1571866367543, 1080, 1053, 27
10, 1571866397547, 1571866397577, 1571866398553, 1006, 976, 30
11, 1571866457689, 1571866457720, 1571866458500, 811, 780, 31
12, 1571866517888, 1571866517918, 1571866518657, 769, 739, 30
13, 1571866578161, 1571866578190, 1571866578735, 574, 545, 29
14, 1571866638382, 1571866638413, 1571866638829, 447, 416, 31
15, 1571866698667, 1571866698691, 1571866699843, 1176, 1152, 24
16, 1571866757938, 1571866757977, 1571866758960, 1022, 983, 39
17, 1571866818247, 1571866818274, 1571866818942, 695, 668, 27
18, 1571866878458, 1571866878487, 1571866879228, 770, 741, 29
19, 1571867059290, 1571867059317, 1571867060319, 1029, 1002, 27
20, 1571867119572, 1571867119598, 1571867120232, 660, 634, 26
21, 1571867239138, 1571867239159, 1571867239387, 249, 228, 21
22, 1571867299469, 1571867299494, 1571867300588, 1119, 1094, 25
23, 1571867359754, 1571867359774, 1571867360666, 912, 892, 20
24, 1571867419985, 1571867420013, 1571867420646, 661, 633, 28
25, 1571867480300, 1571867480331, 1571867480769, 469, 438, 31
26, 1571867539615, 1571867539640, 1571867540812, 1197, 1172, 25
27, 1571867603886, 1571867603916, 1571867604941, 1055, 1025, 30
28, 1571867660220, 1571867660247, 1571867661005, 785, 758, 27
29, 1571867841157, 1571867841187, 1571867842169, 1012, 982, 30
30, 1571867900377, 1571867900406, 1571867901283, 906, 877, 29
31, 1571868141442, 1571868141474, 1571868142520, 1078, 1046, 32
32, 1571868201701, 1571868201727, 1571868202581, 880, 854, 26
33, 1571868262057, 1571868262084, 1571868262817, 760, 733, 27
34, 1571868381602, 1571868381629, 1571868381869, 267, 240, 27
35, 1571868441916, 1571868441942, 1571868442885, 969, 943, 26
36, 1571868502169, 1571868502191, 1571868502999, 830, 808, 22
37, 1571868681844, 1571868681874, 1571868682305, 461, 431, 30
38, 1571868742102, 1571868742129, 1571868743287, 1185, 1158, 27
39, 1571868802382, 1571868802407, 1571868802930, 548, 523, 25
40, 1571868862692, 1571868862720, 1571868863069, 377, 349, 28
41, 1571868983174, 1571868983204, 1571868984172, 998, 968, 30
42, 1571869043425, 1571869043452, 1571869044159, 734, 707, 27
43, 1571869112746, 1571869112769, 1571869113254, 508, 485, 23
44, 1571869162901, 1571869162928, 1571869163281, 380, 353, 27
