0, 1571901972466, 1571901972492, 1571901972852, 386, 360, 26
1, 1571902032687, 1571902032718, 1571902033951, 1264, 1233, 31
2, 1571902111878, 1571902111908, 1571902113050, 1172, 1142, 30
3, 1571902193142, 1571902193171, 1571902194052, 910, 881, 29
4, 1571902212281, 1571902212304, 1571902213136, 855, 832, 23
5, 1571902272418, 1571902272452, 1571902273152, 734, 700, 34
6, 1571902332645, 1571902332675, 1571902333181, 536, 506, 30
7, 1571902453081, 1571902453111, 1571902454301, 1220, 1190, 30
8, 1571902513292, 1571902513322, 1571902514454, 1162, 1132, 30
9, 1571902601513, 1571902601540, 1571902602489, 976, 949, 27
10, 1571902632597, 1571902632626, 1571902633471, 874, 845, 29
11, 1571902692742, 1571902692770, 1571902693555, 813, 785, 28
12, 1571902752968, 1571902753001, 1571902753575, 607, 574, 33
13, 1571902813206, 1571902813235, 1571902813656, 450, 421, 29
14, 1571902873425, 1571902873453, 1571902873709, 284, 256, 28
15, 1571902933706, 1571902933724, 1571902935027, 1321, 1303, 18
16, 1571902992956, 1571902992984, 1571902993527, 571, 543, 28
17, 1571903053233, 1571903053259, 1571903053552, 319, 293, 26
18, 1571903113457, 1571903113488, 1571903114639, 1182, 1151, 31
19, 1571903294236, 1571903294263, 1571903294922, 686, 659, 27
20, 1571903354523, 1571903354549, 1571903355022, 499, 473, 26
21, 1571903474095, 1571903474120, 1571903475279, 1184, 1159, 25
22, 1571903534405, 1571903534429, 1571903535374, 969, 945, 24
23, 1571903594709, 1571903594757, 1571903595643, 934, 886, 48
24, 1571903655018, 1571903655035, 1571903655757, 739, 722, 17
25, 1571903715293, 1571903715318, 1571903715857, 564, 539, 25
26, 1571903774621, 1571903774647, 1571903774860, 239, 213, 26
27, 1571903838910, 1571903838939, 1571903840008, 1098, 1069, 29
28, 1571903895239, 1571903895262, 1571903896216, 977, 954, 23
29, 1571904076187, 1571904076204, 1571904076373, 186, 169, 17
30, 1571904135381, 1571904135407, 1571904136542, 1161, 1135, 26
31, 1571904376411, 1571904376439, 1571904376845, 434, 406, 28
32, 1571904436669, 1571904436695, 1571904437365, 696, 670, 26
33, 1571904497048, 1571904497079, 1571904498036, 988, 957, 31
34, 1571904616549, 1571904616575, 1571904617221, 672, 646, 26
35, 1571904676844, 1571904676870, 1571904677272, 428, 402, 26
36, 1571904737113, 1571904737135, 1571904737421, 308, 286, 22
37, 1571904916745, 1571904916767, 1571904917649, 904, 882, 22
38, 1571904976972, 1571904976989, 1571904977796, 824, 807, 17
39, 1571905037248, 1571905037272, 1571905038016, 768, 744, 24
40, 1571905097553, 1571905097582, 1571905098273, 720, 691, 29
41, 1571905217956, 1571905217994, 1571905219039, 1083, 1045, 38
42, 1571905278232, 1571905278266, 1571905279188, 956, 922, 34
43, 1571905347561, 1571905347581, 1571905348318, 757, 737, 20
44, 1571905397702, 1571905397730, 1571905398234, 532, 504, 28
