0, 1571894629717, 1571894629772, 1571894630139, 422, 367, 55
1, 1571894699921, 1571894699952, 1571894700235, 314, 283, 31
2, 1571894735071, 1571894735098, 1571894736225, 1154, 1127, 27
3, 1571894805220, 1571894805250, 1571894806309, 1089, 1059, 30
4, 1571894875439, 1571894875468, 1571894876369, 930, 901, 29
5, 1571894910563, 1571894910593, 1571894911346, 783, 753, 30
6, 1571894979775, 1571894979803, 1571894980458, 683, 655, 28
7, 1571895050981, 1571895051013, 1571895051466, 485, 453, 32
8, 1571895121235, 1571895121263, 1571895121522, 287, 259, 28
9, 1571895156392, 1571895156419, 1571895157557, 1165, 1138, 27
10, 1571895190469, 1571895190499, 1571895191604, 1135, 1105, 30
11, 1571895718334, 1571895718357, 1571895719143, 809, 786, 23
12, 1571895753463, 1571895753488, 1571895754090, 627, 602, 25
13, 1571895823727, 1571895823754, 1571895824172, 445, 418, 27
14, 1571895894093, 1571895894119, 1571895895292, 1199, 1173, 26
15, 1571895964373, 1571895964397, 1571895965370, 997, 973, 24
16, 1571895999558, 1571895999580, 1571896000455, 897, 875, 22
17, 1571896069847, 1571896069876, 1571896070494, 647, 618, 29
18, 1571896140147, 1571896140173, 1571896140533, 386, 360, 26
19, 1571896175310, 1571896175331, 1571896175689, 379, 358, 21
20, 1571896245681, 1571896245702, 1571896246690, 1009, 988, 21
21, 1571896316037, 1571896316054, 1571896316832, 795, 778, 17
22, 1571896386389, 1571896386406, 1571896386921, 532, 515, 17
23, 1571896421511, 1571896421538, 1571896421922, 411, 384, 27
24, 1571896491877, 1571896491894, 1571896493112, 1235, 1218, 17
25, 1571896562178, 1571896562207, 1571896563101, 923, 894, 29
26, 1571896597339, 1571896597367, 1571896597878, 539, 511, 28
27, 1571896667682, 1571896667711, 1571896668072, 390, 361, 29
28, 1571896738050, 1571896738078, 1571896739020, 970, 942, 28
29, 1571896913811, 1571896913835, 1571896914281, 470, 446, 24
30, 1571896984164, 1571896984190, 1571896985301, 1137, 1111, 26
31, 1571897019302, 1571897019331, 1571897020347, 1045, 1016, 29
32, 1571897089596, 1571897089624, 1571897090542, 946, 918, 28
33, 1571897159936, 1571897159969, 1571897160529, 593, 560, 33
34, 1571897195121, 1571897195146, 1571897195569, 448, 423, 25
35, 1571897230283, 1571897230311, 1571897230715, 432, 404, 28
36, 1571897768607, 1571897768632, 1571897769435, 828, 803, 25
37, 1571897803799, 1571897803820, 1571897804424, 625, 604, 21
38, 1571897874059, 1571897874081, 1571897874452, 393, 371, 22
39, 1571897944306, 1571897944327, 1571897944573, 267, 246, 21
40, 1571897979409, 1571897979438, 1571897980607, 1198, 1169, 29
41, 1571898049741, 1571898049767, 1571898050646, 905, 879, 26
42, 1571898120063, 1571898120087, 1571898120724, 661, 637, 24
43, 1571898190327, 1571898190353, 1571898191350, 1023, 997, 26
