0, 1571866498784, 1571866498811, 1571866499315, 531, 504, 27
1, 1571866528940, 1571866528971, 1571866529352, 412, 381, 31
2, 1571866559026, 1571866559057, 1571866559484, 458, 427, 31
3, 1571866679452, 1571866679479, 1571866680539, 1087, 1060, 27
4, 1571866739736, 1571866739766, 1571866740660, 924, 894, 30
5, 1571866769928, 1571866769955, 1571866770698, 770, 743, 27
6, 1571866830211, 1571866830242, 1571866830847, 636, 605, 31
7, 1571866917560, 1571866917586, 1571866917919, 359, 333, 26
8, 1571866981834, 1571866981861, 1571866982975, 1141, 1114, 27
9, 1571867042081, 1571867042109, 1571867043111, 1030, 1002, 28
10, 1571867132532, 1571867132561, 1571867133259, 727, 698, 29
11, 1571867222896, 1571867222923, 1571867223360, 464, 437, 27
12, 1571867253107, 1571867253134, 1571867253414, 307, 280, 27
13, 1571867343530, 1571867343549, 1571867344448, 918, 899, 19
14, 1571867403836, 1571867403862, 1571867404560, 724, 698, 26
15, 1571867434050, 1571867434077, 1571867434604, 554, 527, 27
16, 1571867524490, 1571867524512, 1571867524801, 311, 289, 22
17, 1571867584779, 1571867584803, 1571867585479, 700, 676, 24
18, 1571867645098, 1571867645123, 1571867645593, 495, 470, 25
19, 1571867705415, 1571867705438, 1571867705683, 268, 245, 23
20, 1571867765672, 1571867765702, 1571867766772, 1100, 1070, 30
21, 1571867827077, 1571867827100, 1571867827893, 816, 793, 23
22, 1571867855174, 1571867855202, 1571867856068, 894, 866, 28
23, 1571867947530, 1571867947556, 1571867948000, 470, 444, 26
24, 1571868007812, 1571868007838, 1571868008193, 381, 355, 26
25, 1571868037950, 1571868037976, 1571868039427, 1477, 1451, 26
26, 1571868128378, 1571868128400, 1571868129328, 950, 928, 22
27, 1571868188557, 1571868188585, 1571868189977, 1420, 1392, 28
28, 1571868243837, 1571868243861, 1571868244903, 1066, 1042, 24
29, 1571868309192, 1571868309219, 1571868309924, 732, 705, 27
30, 1571868339405, 1571868339422, 1571868339963, 558, 541, 17
31, 1571868396672, 1571868396700, 1571868397156, 484, 456, 28
32, 1571868489999, 1571868490025, 1571868491141, 1142, 1116, 26
33, 1571868550243, 1571868550270, 1571868551212, 969, 942, 27
34, 1571868610515, 1571868610541, 1571868611333, 818, 792, 26
35, 1571868640680, 1571868640700, 1571868641322, 642, 622, 20
36, 1571868726971, 1571868726999, 1571868727399, 428, 400, 28
37, 1571868783237, 1571868783253, 1571868783543, 306, 290, 16
38, 1571868808388, 1571868808416, 1571868809724, 1336, 1308, 28
39, 1571868912867, 1571868912894, 1571868913695, 828, 801, 27
40, 1571868962000, 1571868962029, 1571868962880, 880, 851, 29
41, 1571869003205, 1571869003232, 1571869003942, 737, 710, 27
42, 1571869093542, 1571869093567, 1571869093863, 321, 296, 25
43, 1571869153753, 1571869153780, 1571869155062, 1309, 1282, 27
44, 1571869213965, 1571869213993, 1571869215190, 1225, 1197, 28
