0, 1571865687252, 1571865687299, 1571865687567, 315, 268, 47
1, 1571865757446, 1571865757476, 1571865758652, 1206, 1176, 30
2, 1571865792586, 1571865792617, 1571865793789, 1203, 1172, 31
3, 1571865862759, 1571865862789, 1571865863705, 946, 916, 30
4, 1571865932972, 1571865932998, 1571865933895, 923, 897, 26
5, 1571865968119, 1571865968150, 1571865968886, 767, 736, 31
6, 1571866037341, 1571866037370, 1571866037885, 544, 515, 29
7, 1571866108564, 1571866108593, 1571866108971, 407, 378, 29
8, 1571866178818, 1571866178846, 1571866179053, 235, 207, 28
9, 1571866213989, 1571866214021, 1571866215078, 1089, 1057, 32
10, 1571866248084, 1571866248108, 1571866249167, 1083, 1059, 24
11, 1571866775961, 1571866775981, 1571866776843, 882, 862, 20
12, 1571866811091, 1571866811120, 1571866811776, 685, 656, 29
13, 1571866881373, 1571866881395, 1571866881829, 456, 434, 22
14, 1571866951723, 1571866951750, 1571866952957, 1234, 1207, 27
15, 1571867022001, 1571867022031, 1571867022982, 981, 951, 30
16, 1571867057207, 1571867057229, 1571867058064, 857, 835, 22
17, 1571867127477, 1571867127503, 1571867128205, 728, 702, 26
18, 1571867197786, 1571867197816, 1571867198298, 512, 482, 30
19, 1571867232961, 1571867232988, 1571867233309, 348, 321, 27
20, 1571867303349, 1571867303368, 1571867304391, 1042, 1023, 19
21, 1571867373693, 1571867373721, 1571867374487, 794, 766, 28
22, 1571867444086, 1571867444109, 1571867444639, 553, 530, 23
23, 1571867479228, 1571867479254, 1571867479642, 414, 388, 26
24, 1571867549646, 1571867549666, 1571867550487, 841, 821, 20
25, 1571867619970, 1571867619996, 1571867620637, 667, 641, 26
26, 1571867655133, 1571867655161, 1571867655763, 630, 602, 28
27, 1571867725487, 1571867725513, 1571867726755, 1268, 1242, 26
28, 1571867795881, 1571867795907, 1571867796911, 1030, 1004, 26
29, 1571867971653, 1571867971673, 1571867972022, 369, 349, 20
30, 1571868042009, 1571868042027, 1571868043185, 1176, 1158, 18
31, 1571868077133, 1571868077160, 1571868078203, 1070, 1043, 27
32, 1571868147434, 1571868147463, 1571868147664, 230, 201, 29
33, 1571868217731, 1571868217760, 1571868218774, 1043, 1014, 29
34, 1571868252938, 1571868252966, 1571868253863, 925, 897, 28
35, 1571868288121, 1571868288149, 1571868288941, 820, 792, 28
36, 1571868826490, 1571868826512, 1571868827753, 1263, 1241, 22
37, 1571868861696, 1571868861718, 1571868862720, 1024, 1002, 22
38, 1571868931945, 1571868931971, 1571868932861, 916, 890, 26
39, 1571869002182, 1571869002205, 1571869002765, 583, 560, 23
40, 1571869037295, 1571869037319, 1571869037949, 654, 630, 24
41, 1571869107611, 1571869107631, 1571869107970, 359, 339, 20
42, 1571869177925, 1571869177951, 1571869178987, 1062, 1036, 26
43, 1571869248138, 1571869248164, 1571869249050, 912, 886, 26
