0, 1571865709249, 1571865709306, 1571865710014, 765, 708, 57
1, 1571865743387, 1571865743419, 1571865745103, 1716, 1684, 32
2, 1571865883849, 1571865883869, 1571865884259, 410, 390, 20
3, 1571865918931, 1571865918961, 1571865919289, 358, 328, 30
4, 1571865989139, 1571865989170, 1571865990355, 1216, 1185, 31
5, 1571866128610, 1571866128639, 1571866129550, 940, 911, 29
6, 1571866163766, 1571866163795, 1571866164502, 736, 707, 29
7, 1571866686628, 1571866686650, 1571866687471, 843, 821, 22
8, 1571866687650, 1571866687675, 1571866688417, 767, 742, 25
9, 1571866925678, 1571866925705, 1571866926746, 1068, 1041, 27
10, 1571866960818, 1571866960846, 1571866961152, 334, 306, 28
11, 1571867037177, 1571867037206, 1571867038236, 1059, 1030, 29
12, 1571867113571, 1571867113597, 1571867114395, 824, 798, 26
13, 1571867149681, 1571867149709, 1571867150392, 711, 683, 28
14, 1571867220017, 1571867220046, 1571867220632, 615, 586, 29
15, 1571867264221, 1571867264249, 1571867264622, 401, 373, 28
16, 1571867333577, 1571867333599, 1571867334788, 1211, 1189, 22
17, 1571867404886, 1571867404914, 1571867405754, 868, 840, 28
18, 1571867475253, 1571867475274, 1571867475951, 698, 677, 21
19, 1571867509426, 1571867509447, 1571867509902, 476, 455, 21
20, 1571867590851, 1571867590877, 1571867591528, 677, 651, 26
21, 1571867637111, 1571867637138, 1571867637529, 418, 391, 27
22, 1571867713508, 1571867713526, 1571867714581, 1073, 1055, 18
23, 1571867748635, 1571867748660, 1571867749638, 1003, 978, 25
24, 1571867782807, 1571867782839, 1571867783819, 1012, 980, 32
25, 1571867869185, 1571867869212, 1571867869867, 682, 655, 27
26, 1571867939502, 1571867939528, 1571867939940, 438, 412, 26
27, 1571868015818, 1571868015847, 1571868016963, 1145, 1116, 29
28, 1571868072101, 1571868072127, 1571868073042, 941, 915, 26
29, 1571868136367, 1571868136395, 1571868137121, 754, 726, 28
30, 1571868177590, 1571868177610, 1571868178185, 595, 575, 20
31, 1571868258015, 1571868258042, 1571868258371, 356, 329, 27
32, 1571868292176, 1571868292204, 1571868293352, 1176, 1148, 28
33, 1571868368519, 1571868368541, 1571868369551, 1032, 1010, 22
34, 1571868437846, 1571868437873, 1571868438579, 733, 706, 27
35, 1571868492082, 1571868492104, 1571868492722, 640, 618, 22
36, 1571868559333, 1571868559356, 1571868559721, 388, 365, 23
37, 1571868610512, 1571868610540, 1571868610796, 284, 256, 28
38, 1571868679821, 1571868679848, 1571868680799, 978, 951, 27
39, 1571868737080, 1571868737094, 1571868737862, 782, 768, 14
40, 1571868752109, 1571868752141, 1571868752953, 844, 812, 32
41, 1571869035351, 1571869035379, 1571869036236, 885, 857, 28
42, 1571869096598, 1571869096618, 1571869097297, 699, 679, 20
43, 1571869151773, 1571869151800, 1571869152359, 586, 559, 27
44, 1571869206945, 1571869206971, 1571869207424, 479, 453, 26
