0, 1571898323663, 1571898323691, 1571898324630, 967, 939, 28
1, 1571898383867, 1571898383893, 1571898384752, 885, 859, 26
2, 1571898463048, 1571898463081, 1571898463854, 806, 773, 33
3, 1571898544327, 1571898544355, 1571898544965, 638, 610, 28
4, 1571898563451, 1571898563475, 1571898564003, 552, 528, 24
5, 1571898623585, 1571898623614, 1571898624141, 556, 527, 29
6, 1571898683792, 1571898683821, 1571898684149, 357, 328, 29
7, 1571898804219, 1571898804248, 1571898805275, 1056, 1027, 29
8, 1571898864432, 1571898864452, 1571898865439, 1007, 987, 20
9, 1571898952648, 1571898952675, 1571898953424, 776, 749, 27
10, 1571898983727, 1571898983756, 1571898984459, 732, 703, 29
11, 1571899043864, 1571899043893, 1571899044508, 644, 615, 29
12, 1571899104056, 1571899104084, 1571899104799, 743, 715, 28
13, 1571899164311, 1571899164340, 1571899164837, 526, 497, 29
14, 1571899224525, 1571899224555, 1571899224748, 223, 193, 30
15, 1571899284785, 1571899284809, 1571899285944, 1159, 1135, 24
16, 1571899344050, 1571899344076, 1571899345059, 1009, 983, 26
17, 1571899404344, 1571899404370, 1571899404772, 428, 402, 26
18, 1571899464555, 1571899464585, 1571899464922, 367, 337, 30
19, 1571899645338, 1571899645365, 1571899646408, 1070, 1043, 27
20, 1571899705629, 1571899705655, 1571899706305, 676, 650, 26
21, 1571899825170, 1571899825197, 1571899825540, 370, 343, 27
22, 1571899885479, 1571899885508, 1571899885667, 188, 159, 29
23, 1571899945774, 1571899945799, 1571899946960, 1186, 1161, 25
24, 1571900006027, 1571900006056, 1571900007061, 1034, 1005, 29
25, 1571900066317, 1571900066347, 1571900067144, 827, 797, 30
26, 1571900125655, 1571900125679, 1571900126159, 504, 480, 24
27, 1571900189931, 1571900189961, 1571900190380, 449, 419, 30
28, 1571900246272, 1571900246296, 1571900246591, 319, 295, 24
29, 1571900427181, 1571900427208, 1571900427865, 684, 657, 27
30, 1571900486389, 1571900486419, 1571900486955, 566, 536, 30
31, 1571900727435, 1571900727456, 1571900728517, 1082, 1061, 21
32, 1571900787686, 1571900787709, 1571900788648, 962, 939, 23
33, 1571900848013, 1571900848040, 1571900848850, 837, 810, 27
34, 1571900967553, 1571900967575, 1571900967929, 376, 354, 22
35, 1571901027829, 1571901027853, 1571901028166, 337, 313, 24
36, 1571901088089, 1571901088108, 1571901088963, 874, 855, 19
37, 1571901267778, 1571901267802, 1571901268703, 925, 901, 24
38, 1571901328026, 1571901328050, 1571901328730, 704, 680, 24
39, 1571901388303, 1571901388328, 1571901388953, 650, 625, 25
40, 1571901448607, 1571901448634, 1571901449125, 518, 491, 27
41, 1571901569051, 1571901569079, 1571901570221, 1170, 1142, 28
42, 1571901629281, 1571901629310, 1571901630430, 1149, 1120, 29
43, 1571901698611, 1571901698636, 1571901699518, 907, 882, 25
44, 1571901748757, 1571901748784, 1571901749501, 744, 717, 27
